{
    "ህ": "ህ",
"ል": "ል",
"ም": "ም",
"ር": "ር",
"ስ": "ስ",
"ሽ": "ሽ",   
"ቅ": "ቅ",
"ብ": "ብ",
"ቭ": "ቭ",
"ት": "ት",
"ች": "ች",
"ን": "ን",
"ኝ": "ኝ",
"ክ": "ክ",
"ው": "ው",
"ዝ": "ዝ",
"ዥ": "ዥ",
"ይ": "ይ",
"ድ": "ድ",
"ጅ": "ጅ",
"ግ": "ግ",
"ጥ": "ጥ",
"ጭ": "ጭ",
"ጵ": "ጵ",
"ጽ": "ጽ",
"ፍ": "ፍ",
"ፕ": "ፕ",
"ኧ": "ኧ",
"አ": "ኣ",
"ኡ": "ኡ",
"ኢ": "ኢ",
"ኤ": "ኤ",
"እ": "እ",
"ኦ": "ኦ",
"ኸ": "ህኧ",
"ሀ": "ህኣ",
"ሁ": "ህኡ",
"ሂ": "ህኢ",
"ሄ": "ህኤ",
"ሆ": "ህኦ",
"ለ": "ልኧ",
"ሉ": "ልኡ",
"ሊ": "ልኢ",
"ላ": "ልኣ",
"ሌ": "ልኤ",
"ሎ": "ልኦ",
"መ": "ምኧ",
"ሙ": "ምኡ",
"ሚ": "ምኢ",
"ማ": "ምኣ",
"ሜ": "ምኤ",
"ሞ": "ምኦ",
"ረ": "ርኧ",
"ሩ": "ርኡ",
"ሪ": "ርኢ",
"ራ": "ርኣ",
"ሬ": "ርኤ",
"ሮ": "ርኦ",
"ሰ": "ስኧ",
"ሱ": "ስኡ",
"ሲ": "ስኢ",
"ሳ": "ስኣ",
"ሴ": "ስኤ",
"ሶ": "ስኦ",
"ሸ": "ሽኧ",
"ሹ": "ሽኡ",
"ሺ": "ሽኢ",
"ሻ": "ሽኣ",
"ሼ": "ሽኤ",
"ሾ": "ሽኦ",
"ቀ": "ቅኧ",
"ቁ": "ቅኡ",
"ቂ": "ቅኢ",
"ቃ": "ቅኣ",
"ቄ": "ቅኤ",
"ቆ": "ቅኦ",
"በ": "ብኧ",
"ቡ": "ብኡ",
"ቢ": "ብኢ",
"ባ": "ብኣ",
"ቤ": "ብኤ",
"ቦ": "ብኦ",
"ቨ": "ቭኧ",
"ቩ": "ቭኡ",
"ቪ": "ቭኢ",
"ቫ": "ቭኣ",
"ቬ": "ቭኤ",
"ቮ": "ቭኦ",
"ተ": "ትኧ",
"ቱ": "ትኡ",
"ቲ": "ትኢ",
"ታ": "ትኣ",
"ቴ": "ትኤ",
"ቶ": "ትኦ",
"ቸ": "ችኧ",
"ቹ": "ችኡ",
"ቺ": "ችኢ",
"ቻ": "ችኣ",
"ቼ": "ችኤ",
"ቾ": "ችኦ",
"ነ": "ንኧ",
"ኑ": "ንኡ",
"ኒ": "ንኢ",
"ና": "ንኣ",
"ኔ": "ንኤ",
"ኖ": "ንኦ",
"ኘ": "ኝኧ",
"ኙ": "ኝኡ",
"ኚ": "ኝኢ",
"ኛ": "ኝኣ",
"ኜ": "ኝኤ",
"ኞ": "ኝኦ",
"ከ": "ክኧ",
"ኩ": "ክኡ",
"ኪ": "ክኢ",
"ካ": "ክኣ",
"ኬ": "ክኤ",
"ኮ": "ክኦ",
"ኰ": "ክኦ",
"ወ": "ውኧ",
"ዉ": "ውኡ",
"ዊ": "ውኢ",
"ዋ": "ውኣ",
"ዌ": "ውኤ",
"ዎ": "ውኦ",
"ዘ": "ዝኧ",
"ዙ": "ዝኡ",
"ዚ": "ዝኢ",
"ዛ": "ዝኣ",
"ዜ": "ዝኤ",
"ዞ": "ዝኦ",
"ዠ": "ዥኧ",
"ዡ": "ዥኡ",
"ዢ": "ዥኢ",
"ዣ": "ዥኣ",
"ዤ": "ዥኤ",
"ዦ": "ዥኦ",
"የ": "ይኧ",
"ዩ": "ይኡ",
"ዪ": "ይኢ",
"ያ": "ይኣ",
"ዬ": "ይኤ",
"ዮ": "ይኦ",
"ደ": "ድኧ",
"ዱ": "ድኡ",
"ዲ": "ድኢ",
"ዳ": "ድኣ",
"ዴ": "ድኤ",
"ዶ": "ድኦ",
"ጀ": "ጅኧ",
"ጁ": "ጅኡ",
"ጂ": "ጅኢ",
"ጃ": "ጅኣ",
"ጄ": "ጅኤ",
"ጆ": "ጅኦ",
"ገ": "ግኧ",
"ጉ": "ግኡ",
"ጊ": "ግኢ",
"ጋ": "ግኣ",
"ጌ": "ግኤ",
"ጐ": "ግኦ",
"ጠ": "ጥኧ",
"ጡ": "ጥኡ",
"ጢ": "ጥኢ",
"ጣ": "ጥኣ",
"ጤ": "ጥኤ",
"ጦ": "ጥኦ",
"ጨ": "ጭኧ",
"ጩ": "ጭኡ",
"ጪ": "ጭኢ",
"ጫ": "ጭኣ",
"ጬ": "ጭኤ",
"ጮ": "ጭኦ",
"ጰ": "ጵኧ",
"ጱ": "ጵኡ",
"ጲ": "ጵኢ",
"ጳ": "ጵኣ",
"ጴ": "ጵኤ",
"ጶ": "ጵኦ",
"ጸ": "ጽኧ",
"ጹ": "ጽኡ",
"ጺ": "ጽኢ",
"ጻ": "ጽኣ",
"ጼ": "ጽኤ",
"ጾ": "ጽኦ",
"ፈ": "ፍኧ",
"ፉ": "ፍኡ",
"ፊ": "ፍኢ",
"ፋ": "ፍኣ",
"ፌ": "ፍኤ",
"ፎ": "ፍኦ",
"ፐ": "ፕኧ",
"ፑ": "ፕኡ",
"ፒ": "ፕኢ",
"ፓ": "ፕኣ",
"ፔ": "ፕኤ",
"ፖ": "ፕኦ",
"ኋ": "ህኡኣ",
"ሏ": "ልኡኣ",
"ሟ": "ምኡኣ",
"ሯ": "ርኡኣ",
"ሷ": "ስኡኣ",
"ሿ": "ሽኡኣ",
"ቋ": "ቅኡኣ",
"ቧ": "ብኡኣ",
"ቯ": "ቭኡኣ",
"ቷ": "ትኡኣ",
"ቿ": "ችኡኣ",
"ⶇ": "ችኡኣ",
"ኗ": "ንኡኣ",
"ኟ": "ኝኡኣ",
"ኳ": "ክኡኣ",
"ዟ": "ዝኡኣ",
"ዧ": "ዥኡኣ",
"ዷ": "ድኡኣ",
"ጇ": "ጅኡኣ",
"ጓ": "ግኡኣ",
"ጏ": "ግኡኣ",
"ጧ": "ጥኡኣ",
"ጯ": "ጭኡኣ",
"ጷ": "ጵኡኣ",
"ጿ": "ጽኡኣ",
"ፏ": "ፍኡኣ",
"ፗ": "ፕኡኣ",
"ጔ": "ግኡኤ",
"ኴ": "ክኡኤ",
"ኌ": "ህኡኤ",
"ቌ": "ቅኡኤ",
"ጒ": "ግኡኢ",
"ኲ": "ክኡኢ",
"ኊ": "ህኡኢ",
"ቊ": "ቅኡኢ",
"ᎉ": "ፍኡኢ",
"ጕ": "ግኡእ",
"ዂ": "ህኡኢ",
    "ኵ": "ክኡእ",
"ቍ": "ቅኡእ",
"ፙ": "ምኢኣ",
"ፚ": "ፍኢኣ",
"ዅ": "ህኡእ",
"ᎊ" : "ፍኡኤ",
"ᎋ": "ፍኡኧ",
"ፘ":  "ርኢኣ",
"ᎌ":  "ፕኡኣ",
"ᎍ":  "ፕኡኢ",
"ᎎ":  "ትኡኤ",
"ᎏ":  "ፕኡኤ",
"ቐ":  "ቅህኧ",
"ቑ":  "ቅህኡ",
"ቒ":  "ቅህኢ",
"ቓ":  "ቅህኣ",
	"ቔ":  "ቅህኤ",
	"ቕ":  "ቅህእ",
	"ቖ":  "ቅህኦ",
		"ቘ":  "ቅህኡኣ",
		"ቚ":  "ቅህኡኢ",
	"ቛ":  "ቅህኡኣ",
	"ቜ":  "ቅህኡኤ"}