{
    "[PAD]" : 0,
    "[UNK]" : 1,
    "|" : 2,
    "ኧ" : 3,
    "ኡ" : 4,
    "ኢ" : 5,
    "ኣ" : 6,
    "ኤ" : 7,
    "እ" : 8,
    "ኦ" : 9,
    "ህ" : 10,
    "ል" : 11,
    "ም" : 12,
    "ር" : 13,
    "ስ" : 14,
    "ሽ" : 15,
    "ቅ" : 16,
    "ብ" : 17,
    "ቭ" : 18,
    "ት" : 19,
    "ች" : 20,
    "ን" : 21,
    "ኝ" : 22,
    "ክ" : 23,
    "ው" : 24,
    "ዝ" : 25,
    "ዥ" : 26,
    "ይ" : 27,
    "ድ" : 28,
    "ጅ" : 29,
    "ግ" : 30,
    "ጥ" : 31,
    "ጭ" : 32,
    "ጵ" : 33,
    "ጽ" : 34,
    "ፍ" : 35,
    "ፕ" : 36
}